2	2	2	2	2	2	2	2	2	2	2	2	2	2	2	2	2	2	2	2	2	2	2	2	2	2	2	2
2	2	2	2	2	2	2	2	2	2	2	2	2	2	2	2	2	2	2	2	2	2	2	2	2	2	2	2
2	2	2	2	2	2	2	2	2	2	2	2	2	2	2	2	2	2	2	2	2	2	2	2	2	2	2	2
2	2	2	2	2	2	2	2	2	2	2	2	2	2	2	2	2	2	2	2	2	2	2	2	2	2	2	2
2	2	2	2	2	2	2	2	2	2	2	2	2	2	2	2	2	2	2	2	2	2	2	2	2	2	2	2
2	2	2	2	2	2	2	2	2	2	2	2	2	2	2	2	2	2	2	2	2	2	2	2	2	2	2	2
2	2	2	0	0	0	0	0	0	0	0	0	0	0	0	0	0	0	0	0	0	0	0	0	0	2	2	2
2	2	2	0	4	4	4	4	4	4	4	4	4	4	4	4	4	4	4	4	4	4	4	4	0	2	2	2
2	2	2	0	4	0	0	0	0	4	0	0	0	0	0	0	0	0	4	0	0	0	0	4	0	2	2	2
2	2	2	0	4	0	0	0	0	4	0	0	0	0	0	0	0	0	4	0	0	0	0	4	0	2	2	2
2	2	2	0	4	0	0	0	0	4	0	0	0	0	0	0	0	0	4	0	0	0	0	4	0	2	2	2
2	2	2	0	4	4	4	4	5	4	4	4	4	4	4	4	4	4	4	5	4	4	4	4	0	2	2	2
2	2	2	0	0	0	4	0	0	0	0	1	0	0	0	0	1	0	0	0	0	4	0	0	0	2	2	2
2	2	2	2	2	0	4	0	0	0	0	1	0	0	0	0	1	0	0	0	0	4	0	2	2	2	2	2
2	2	2	2	2	0	4	0	0	1	1	1	1	1	1	1	1	1	1	0	0	4	0	2	2	2	2	2
2	2	2	2	2	0	4	0	0	1	3	3	3	3	3	3	3	3	1	0	0	4	0	2	2	2	2	2
2	2	2	0	0	0	4	0	0	1	3	3	3	3	3	3	3	3	1	0	0	4	0	0	0	2	2	2
2	2	2	0	4	5	4	0	0	1	3	3	3	3	3	3	3	3	1	0	0	4	5	4	0	2	2	2
2	2	2	0	4	0	0	0	0	1	3	3	3	3	3	3	3	3	1	0	0	0	0	4	0	2	2	2
0	0	0	0	4	0	0	0	0	1	3	3	3	3	3	3	3	3	1	0	0	0	0	4	0	0	0	0
1	1	1	1	4	4	4	4	4	1	1	1	1	1	1	1	1	1	1	4	4	4	4	4	1	1	1	1
0	0	0	0	4	0	0	0	0	1	0	0	0	0	0	0	0	0	1	0	0	0	0	4	0	0	0	0
2	2	2	0	4	0	0	0	0	1	0	0	0	0	0	0	0	0	1	0	0	0	0	4	0	2	2	2
2	2	2	0	4	4	4	4	4	4	4	4	4	1	1	4	4	4	4	4	4	4	4	4	0	2	2	2
2	2	2	0	4	0	0	0	0	0	0	0	0	4	0	0	0	0	0	0	0	0	0	4	0	2	2	2
2	2	2	0	5	0	0	0	0	0	0	0	0	4	0	0	0	0	0	0	0	0	0	5	0	2	2	2
2	2	2	0	4	4	4	4	4	4	4	0	0	4	4	4	4	4	4	4	4	4	4	4	0	2	2	2
2	2	2	0	0	0	0	0	0	0	4	0	0	0	0	0	4	0	0	0	0	0	0	0	0	2	2	2
2	2	2	0	0	0	0	0	0	0	4	0	0	0	0	0	4	0	0	0	0	0	0	0	0	2	2	2
2	2	2	0	1	1	1	1	1	1	4	4	4	4	4	4	4	1	1	1	1	1	1	1	0	2	2	2
2	2	2	0	0	0	0	0	0	0	0	0	0	0	0	0	0	0	0	0	0	0	0	0	0	2	2	2
2	2	2	2	2	2	2	2	2	2	2	2	2	2	2	2	2	2	2	2	2	2	2	2	2	2	2	2
2	2	2	2	2	2	2	2	2	2	2	2	2	2	2	2	2	2	2	2	2	2	2	2	2	2	2	2
2	2	2	2	2	2	2	2	2	2	2	2	2	2	2	2	2	2	2	2	2	2	2	2	2	2	2	2
2	2	2	2	2	2	2	2	2	2	2	2	2	2	2	2	2	2	2	2	2	2	2	2	2	2	2	2
2	2	2	2	2	2	2	2	2	2	2	2	2	2	2	2	2	2	2	2	2	2	2	2	2	2	2	2
