XXXXXXX
X.....X
X.XXX.X
X. X..X
XX...XX
X .XXXX
XXXXXXX